Contracts over six months are allowed!
Released under CC-0.

russss: Last.fm -> Smarkets
muz: Last.fm -> Mendeley -> BBC
jonty: Last.fm -> ?! MAKE HIM sexy CAKE?
benward: Yahoo -> Yahoo US -> Twitter
phae: BBC -> Nature -> Alpha.gov
garethr: GCap -> GlassesDirect -> FreeAgent -> Alpha.gov
creature: Sun Microsystems -> Framestore CFC -> Last.fm
mokele: Last.fm -> Smarkets
neilcrosby: Yahoo  -> BBC (Job obtained via a bribe of cake)
bradwright: Yahoo -> GCap -> Smarkets
kapowaz: unboxed - > photobox
alicebartlett: Assanka -> BERG
Boozeniges: GCap -> LBi -> Nature -> Mozilla
cackhanded: Yahoo -> linden labs -> Artfinder
jaylett: Infinity Realities -> tangozebra -> Kudocities -> EMI -> Artfinder
dsingleton: Spring Digital -> Last.fm
Tamsin: Yahoo -> Moo
ashb: Fotango -> NAP -> DigiResults
dom: icom -> LBi -> DigiResults
georgebrock: Reevoo -> Artfinder
chrismear: ? -> unboxed
amln: ? -> Mysociety
abscond: peoplesmusicstore -> unboxed -> BERG
mnowster: tangozebra -> Acknowledge -> glasses direct -> Artfinder
mike stenhouse: trampoline - > Aframe
paulcuth: ? -> gamesys
fatbusinessman: torchbox (?) -> glasses direct
lizard: icom -> unboxed
dan webb: Vivabit -> peoplesmusicstore -> Twitter
RJ: Last.fm -> IRCCloud
JWheare: Last.fm -> IRCCloud
Jake Archibald: BBC -> theTeam

